0 0 0 0 0 6 0 0 0 0 0 0 6 0 0 0 0 0 0 6 0 0 0 0 0
0 0 0 0 0 0 0 0 0 0 0 0 0 0 0 0 0 0 0 0 0 0 0 0 0
0 0 0 0 0 0 0 0 0 0 0 0 0 0 0 0 0 0 0 0 0 0 0 0 0
0 0 3 3 3 0 0 0 0 0 0 0 0 0 0 0 0 0 0 0 3 3 3 0 0
0 0 1 7 1 0 0 0 0 0 0 0 0 0 0 0 0 0 0 0 1 7 1 0 0
0 0 0 0 1 1 1 0 0 0 0 0 0 0 0 0 0 0 1 1 1 0 0 0 0
0 0 0 0 7 1 7 0 0 0 0 0 1 0 0 0 0 0 7 1 7 0 0 0 0
0 0 0 0 0 3 3 3 0 0 0 1 0 1 0 0 0 3 3 3 0 0 0 0 0
0 0 0 0 0 0 0 0 0 0 3 0 0 0 3 0 0 0 0 0 0 0 0 0 0
8 0 5 8 0 8 0 0 0 3 8 0 0 8 0 3 5 8 0 5 5 8 0 8 0
0 0 8 0 0 0 0 5 1 0 0 0 4 0 0 0 1 0 0 8 0 0 0 0 0
5 5 0 0 8 0 5 1 0 0 0 4 4 4 0 0 0 1 5 0 0 8 0 5 5
8 0 8 0 0 0 8 0 1 0 8 0 4 8 0 0 1 5 8 0 8 0 0 8 0
0 0 0 0 5 5 0 0 5 3 0 0 0 0 0 3 0 0 0 0 0 0 5 0 0
0 0 0 0 0 0 0 0 0 0 3 0 0 0 3 0 0 0 0 0 0 0 0 0 0
0 0 0 0 0 0 0 0 0 0 0 1 0 1 0 0 0 0 0 0 0 0 0 0 0
7 7 0 7 7 7 0 7 7 7 7 7 1 7 7 7 7 7 0 7 7 7 0 7 7
7 7 0 1 0 1 0 0 0 0 0 0 0 0 0 0 0 0 0 1 0 1 0 7 7
1 1 0 0 7 0 0 1 1 1 1 0 7 0 1 1 1 1 0 0 7 0 0 1 1
0 0 0 1 0 1 0 0 0 0 0 1 0 1 0 0 0 0 0 1 0 1 0 0 0
0 0 0 0 0 0 0 0 0 0 0 3 1 3 0 0 0 0 0 0 0 0 0 0 0
0 0 0 0 0 0 0 0 0 0 0 0 0 0 0 0 0 0 0 0 0 0 0 0 0
0 0 0 0 0 0 0 0 0 0 1 1 1 1 1 0 0 0 0 0 0 0 0 0 0
0 0 0 0 0 0 0 0 0 0 1 0 0 0 1 0 0 0 0 0 0 0 0 0 0
0 0 0 0 0 0 0 0 0 0 1 0 2 0 1 0 0 0 0 0 0 0 0 0 0