8 0 8 0 5 6 0 0 0 0 0 0 6 0 0 0 0 0 0 6 5 8 0 8 0
0 0 0 0 5 5 0 0 0 0 0 0 0 0 0 0 0 0 0 5 5 0 0 0 0
8 0 8 0 8 0 0 0 0 0 0 0 0 0 0 0 0 0 0 8 0 8 0 8 0
0 0 0 0 0 0 0 0 0 0 0 0 0 0 0 0 0 0 0 0 0 0 0 0 0
8 0 8 0 8 0 0 0 0 1 1 3 3 3 1 0 0 0 0 8 0 8 0 8 0
0 0 0 0 0 0 0 0 0 1 7 7 7 7 1 0 0 0 0 0 0 0 0 0 0
0 0 0 0 0 0 0 1 0 3 7 7 7 7 3 0 3 0 0 0 0 0 0 0 0
0 0 0 0 0 3 4 4 4 4 4 4 4 4 4 4 4 4 3 0 0 0 0 0 0
0 0 0 0 0 0 0 1 1 1 0 0 0 0 1 1 1 0 0 0 0 0 0 0 0
0 0 1 1 3 0 1 7 7 7 1 0 0 1 7 7 7 1 0 3 1 1 0 0 0
0 0 3 7 7 0 1 7 0 0 0 0 0 1 7 0 7 1 0 7 7 3 0 0 0
0 0 3 7 7 0 1 7 0 0 0 0 0 1 7 0 7 1 0 7 7 3 0 0 0
0 0 3 7 7 0 1 7 0 1 1 0 0 1 7 0 7 1 0 7 7 3 0 0 0
0 0 1 1 3 0 1 7 7 7 1 0 0 1 7 7 7 1 0 3 1 1 0 0 0
0 0 0 0 0 0 0 1 1 1 0 0 0 0 1 1 1 0 0 0 0 0 0 0 0
0 0 0 0 0 3 0 0 0 0 0 0 0 0 0 0 0 0 3 0 0 0 0 0 0
0 0 0 0 0 0 0 0 3 0 0 0 0 0 0 0 3 0 3 0 0 0 0 0 0
0 0 0 0 0 0 0 0 0 0 0 0 0 0 0 1 0 0 0 0 0 0 0 0 0
0 0 0 0 0 0 0 0 0 0 1 3 3 3 3 1 0 0 0 0 0 0 0 0 0
8 0 8 0 8 0 0 0 0 0 0 0 0 0 0 0 0 0 0 8 0 8 0 8 0
0 0 0 0 0 0 0 0 0 0 0 0 0 0 0 0 0 0 0 0 0 0 0 0 0
8 0 8 0 8 0 0 0 0 0 0 0 0 0 0 0 0 0 0 8 0 8 0 8 0
0 0 0 0 0 0 0 0 0 0 1 1 1 1 1 0 0 0 0 0 0 0 0 0 0
8 0 8 0 8 0 0 0 0 0 1 0 0 0 1 0 0 0 0 8 0 8 0 8 0
0 0 0 0 0 0 0 0 0 0 1 0 2 0 1 0 0 0 0 0 0 0 0 0 0